##############
##############
##....?.....##
##...####...##
##..#....#..##
##..#....#..##
##.#..@..#..##
##.#.....#..##
##.....##...##
##....#.....##
##....#.....##
##....#.....##
##....#.....##
##..........##
##....#.....##
##..........##
##############
##############